Cindy    ----    fjames@gmail.com
Henry    ----    timothycortez@gmail.com
Michael    ----    sharon49@yahoo.com
Patricia    ----    johnsondonna@hotmail.com
Katherine    ----    davidmartinez@yahoo.com
Harry    ----    sarahthornton@hotmail.com
Christina    ----    whenry@gmail.com
Travis    ----    justin18@hotmail.com
Karen    ----    pdean@yahoo.com
Aaron    ----    robert67@yahoo.com
Tina    ----    rgonzalez@gmail.com
Rachel    ----    charlesjames@hotmail.com
Kimberly    ----    ashleeclark@yahoo.com
Amber    ----    shawsavannah@yahoo.com
Richard    ----    medinachristopher@hotmail.com
Tracy    ----    simpsonaaron@hotmail.com
Rebekah    ----    shannonortiz@gmail.com
Ashley    ----    david81@hotmail.com
Marcus    ----    melanie25@yahoo.com
Antonio    ----    mccartymary@hotmail.com
Caitlyn    ----    hickmanandrew@yahoo.com
Victoria    ----    tara78@yahoo.com
Lisa    ----    william68@gmail.com
Diana    ----    jamesrobinson@gmail.com
Wendy    ----    ksoto@hotmail.com
Ronald    ----    kiddchristopher@yahoo.com
Alfred    ----    tracy50@gmail.com
Kyle    ----    natalie94@yahoo.com
Kerri    ----    yhanson@yahoo.com
Pamela    ----    nterry@hotmail.com
Rebecca    ----    hardingpaige@hotmail.com
Diane    ----    ramirezjacqueline@gmail.com
Timothy    ----    feliciacoleman@hotmail.com
Thomas    ----    nellis@gmail.com
Makayla    ----    bartonsierra@gmail.com
Kelly    ----    dcarter@gmail.com
Margaret    ----    johnwilliams@yahoo.com
William    ----    bsmith@gmail.com
Holly    ----    xscott@gmail.com
Jodi    ----    robert77@hotmail.com
Colleen    ----    ashley79@hotmail.com
Frank    ----    egarrett@gmail.com
Danielle    ----    bfischer@hotmail.com
Jason    ----    melissa76@gmail.com
Stephen    ----    philip49@yahoo.com
Darrell    ----    lawrencecoffey@hotmail.com
Rhonda    ----    alexander67@yahoo.com
Erik    ----    douglasbrown@yahoo.com
Brittney    ----    leeangela@yahoo.com
Jennifer    ----    rneal@yahoo.com
Brianna    ----    jonescarla@yahoo.com
Sandra    ----    brandon41@gmail.com
Troy    ----    oclark@gmail.com
Ricky    ----    davidaguilar@gmail.com
Daniel    ----    amber85@gmail.com
Mary    ----    upollard@hotmail.com
James    ----    annjohnson@gmail.com
Gina    ----    michael90@yahoo.com
Cassandra    ----    kwood@yahoo.com
Paul    ----    taramckenzie@gmail.com
Cole    ----    yjensen@yahoo.com
Julie    ----    chelseywebb@yahoo.com
David    ----    wardthomas@hotmail.com
Adam    ----    benjaminedwards@hotmail.com
Stacy    ----    charles39@yahoo.com
Carl    ----    jeffreyjones@yahoo.com
Kerry    ----    ngomez@gmail.com
Darryl    ----    mclaughlinbradley@yahoo.com
Steven    ----    christina10@yahoo.com
Joy    ----    timothy99@hotmail.com
Erica    ----    mario19@hotmail.com
Jacqueline    ----    kimberly95@hotmail.com
Paula    ----    baileyanthony@hotmail.com
Joshua    ----    matthew21@yahoo.com
George    ----    dianamontoya@hotmail.com
Stacey    ----    crystal24@hotmail.com
Randall    ----    robertcooper@gmail.com
Lindsey    ----    alejandrapeterson@hotmail.com
Emily    ----    lisa55@yahoo.com
Jasmine    ----    woodwardjerry@gmail.com
Jill    ----    dominiquelopez@gmail.com
Brian    ----    travischaney@hotmail.com
Douglas    ----    jessepowers@yahoo.com
Bradley    ----    alexanderstephanie@yahoo.com
Anthony    ----    williamlopez@gmail.com
Chris    ----    miranda27@yahoo.com
Tiffany    ----    atkinsondavid@yahoo.com
Amy    ----    collinsmichael@yahoo.com
John    ----    fryedaniel@gmail.com
Michelle    ----    stephaniemullen@yahoo.com
Jacob    ----    wmalone@gmail.com
Samantha    ----    laurapearson@yahoo.com
Laurie    ----    ashley47@yahoo.com
Kristina    ----    bbarnett@gmail.com
Shelia    ----    garciajason@yahoo.com
Christine    ----    angelaclements@gmail.com
Adrian    ----    lewisjavier@gmail.com
Kayla    ----    salazartara@hotmail.com
Lucas    ----    lbutler@gmail.com
Susan    ----    markbooth@yahoo.com
Debra    ----    josephamy@yahoo.com
Micheal    ----    raymond26@hotmail.com
Jonathan    ----    dwhite@gmail.com
Brent    ----    vgarcia@yahoo.com
Jay    ----    saunderskeith@gmail.com
Tonya    ----    petersuarez@gmail.com
Katie    ----    shawnmartin@hotmail.com
Jessica    ----    daniellehamilton@yahoo.com
Deanna    ----    robert21@gmail.com
Vicki    ----    jamie27@gmail.com
Justin    ----    tammy32@hotmail.com
Annette    ----    hcastro@gmail.com
Robert    ----    rhubbard@yahoo.com
Christopher    ----    hobbsdean@yahoo.com
Andrew    ----    barbarakey@yahoo.com
Randy    ----    sarah72@hotmail.com
Blake    ----    andreasingh@gmail.com
Evelyn    ----    dmendez@gmail.com
Craig    ----    jacob12@hotmail.com
Marissa    ----    martineztodd@gmail.com
Brandon    ----    wardjason@gmail.com
Matthew    ----    lgarcia@yahoo.com
Nicole    ----    nschneider@gmail.com
Alexis    ----    christinereed@gmail.com
Brittany    ----    bridgetguerrero@yahoo.com
Dana    ----    holmesethan@hotmail.com
Crystal    ----    pcurtis@hotmail.com
Jaclyn    ----    jessica29@hotmail.com
Kristen    ----    hdodson@yahoo.com
Linda    ----    hlang@yahoo.com
Carolyn    ----    kleinabigail@yahoo.com
Megan    ----    carrieanderson@yahoo.com
Jonathon    ----    randall69@yahoo.com
Kari    ----    lanthony@gmail.com
Melissa    ----    ericanderson@yahoo.com
Molly    ----    grios@gmail.com
Sean    ----    kleinrichard@hotmail.com
Caleb    ----    zhangjohn@hotmail.com
Veronica    ----    marshcharles@yahoo.com
Jean    ----    reiddylan@yahoo.com
Isaac    ----    jason05@gmail.com
Catherine    ----    adam88@gmail.com
Candice    ----    cartergregory@yahoo.com
Michaela    ----    perezmatthew@gmail.com
Jordan    ----    shaneadams@hotmail.com
Gloria    ----    anthonyward@yahoo.com
Carol    ----    austinhouse@gmail.com
Jesse    ----    derek38@hotmail.com
Alison    ----    melissawalker@yahoo.com
Caitlin    ----    dmckenzie@yahoo.com
Sharon    ----    julie76@hotmail.com
Carrie    ----    mark37@yahoo.com
Angel    ----    gcunningham@gmail.com
Charles    ----    hillmatthew@yahoo.com
Heather    ----    michelledavidson@hotmail.com
Jeffrey    ----    willie79@gmail.com
Amanda    ----    jessica10@gmail.com
Joseph    ----    jeremiah92@hotmail.com
Ryan    ----    angela17@hotmail.com
Derek    ----    timothywatson@yahoo.com
Zachary    ----    brittanyhansen@hotmail.com
Briana    ----    thopkins@hotmail.com
Cheryl    ----    steven21@yahoo.com
Edward    ----    elijah51@hotmail.com
Brenda    ----    jonesamanda@gmail.com
Lori    ----    adrian43@gmail.com
Yvette    ----    sean91@gmail.com
Jose    ----    jennifer60@yahoo.com
Jesus    ----    caldwellgregory@yahoo.com
Marc    ----    monicajohnson@hotmail.com
Nancy    ----    matthew07@hotmail.com
Phillip    ----    charles48@yahoo.com
Maurice    ----    paulkevin@hotmail.com
Jeremy    ----    bsmith@gmail.com
Cory    ----    eileen62@yahoo.com
Tony    ----    powelldana@yahoo.com
Peter    ----    joshuahart@hotmail.com
Morgan    ----    william64@yahoo.com
Nathan    ----    zcampos@hotmail.com
Renee    ----    jake39@yahoo.com
Jared    ----    hwilliams@gmail.com
Connie    ----    jennifer38@yahoo.com
Brett    ----    kevinmartin@yahoo.com
Wesley    ----    cervantestaylor@gmail.com
Noah    ----    leebecky@yahoo.com
Herbert    ----    snyderthomas@hotmail.com
Grace    ----    kevin11@yahoo.com
Teresa    ----    ophillips@yahoo.com
Robyn    ----    karengarcia@yahoo.com
Curtis    ----    jessica71@yahoo.com
Angela    ----    fvazquez@hotmail.com
Paige    ----    foxrita@hotmail.com
Johnny    ----    kimberly86@yahoo.com
Eric    ----    jalvarado@hotmail.com
Andrea    ----    acostakendra@gmail.com
Cynthia    ----    theresahall@yahoo.com
Rachael    ----    kyletucker@hotmail.com
Marie    ----    haroldjohns@gmail.com
Mark    ----    kyle64@yahoo.com
Anna    ----    jeremy64@yahoo.com
